##############################
#............................#
#...########..........#......#
#.....................#......#
#.....................#......#
#.....................#......#
#.....................#......#
############.........#########
#..........#.................#
#............................#
#..........#.................#
##############################